%%%%%%%%%%%%%%%%%%%%%%%%%%%%%%%%%%%%%%%%%%%%%%%%%%%%%%%%%%%%%
%P    %       %             %         %     %           %   %
%%% %%% % %%%%% %%%%% %%%%% %%% %%%%%%% % %%% % %%%%%%% % %%%
%   %         %   % %   % %   %         %   % %     % % %   %
% %%% %%% %%% %%% % %%% % %%% % %%%%%% %%%% % %%%%% % % %%% %
% %   % %   % %   %   % %                 % %   % % %       %
%   %%% % % % % % % % % %%% % %%%%%%% %%% % %%% % % %%%%%%% %
% %   %   % %   %   % %   % %     %   %   %     % %   %   % %
% %%%%%%% % % %%% %%% %%% % %%% %%% % % %%%%%%%%% %%% % % % %
%   %   % %       % % %   %   % %   % % %     %     %   % % %
% % %%% % %%%%%%%%% % % %%%%% % % %%% % % %%% %%%%% %%%%% %%%
% %   % %   %         % %   % %     %   % % %           %   %
% %%%%% %%%%% %%%%% %%% % % % %%%%%%%%% % % %%% %%% %%% %%% %
%     %       %         % % %         %   %     %     %   % %
% %%% %%% %%%%% %%%%% % %%% %%% %%%%% %%%%%% %%%% %%% %%% % %
%   %     %     %   % %         % % %   %     %   %     % % %
% % %%% %%% %%% %%% % %%% %%%% %% % %%% % %%% % %%% %%% %%% %
% %   %   %       %       %       %   %   % % % %     %   % %
% % %%% % %%%% %% %%%%%%%%% %%%%% %%% % %%% % % % % %%%%% % %
% %     %   %     %       %   % .     %     %   % % %   % % %
% %%%% %% % % %%%%% %%%%% %%% % %%%% %% %%% %% %% %%% % % % %
%         % %           %     %           %           % %  .%
%%%%%%%%%%%%%%%%%%%%%%%%%%%%%%%%%%%%%%%%%%%%%%%%%%%%%%%%%%%%%
