%%%%%%%%%%%%                                                                               
%%%%%%%%%%%%%                                                                              
%%%%%%%%%%%%%                                                                              
%%%%%%%%%%%%%%                                                                             
%%%%%%%%%%%%%%                                                                             
%%%%%%%%%%%%%%                                                                             
%%%%%%%%%%%%%%%                                                                            
%%%%%%%%%%%%%%%                                                                            
%%%%%%%%%%%%%%%                                                                            
%%%%%%%%%%%%%%%                                                                            
%%%%%%%%%%%%%%%                                                                            
%%%%%%%%%%%%%%%                                                                            
%%%%%%%%%%%%%%%                                                                            
%%%%%%%%%%%%%%%                                                                            
%%%%%%%%%%%%%%%                                                                            
%%%%%%%%%%%%%%%                                                                            
%%%%%%%%%%%%%%%                                                                            
%%%%%%%%%%%%%%%                                                                            
%%%%%%%%%%%%%%%                                                                            
%%%%%%%%%%%%%%%                                                                            
%%%%%%%%%%%%%%%                                                                            
%%%%%%%%%%%%%%%                                                                            
%%%%%%%%%%%%%%%                                                                            
%%%%%%%%%%%%%%%                                                                            
%%%%%%%%%%%%%%%                                                                            
%%%%%%%%%%%%%%%                                                                            
%%%%%%%%%%%%%%%                                                                            
%%%%%%%%%%%%%%                                                                             
%%%%%%%%%%%%%%                                                                             
%%%%%%%%%%%%%%                                                                             
%%%%%%%%%%%%%%                                                                             
%%%%%%%%%%%%%%                                                                             
%%%%%%%%%%%%%                                                                              
%%%%%%%%%%%%%                                                                              
%%%%%%%%%%%%%                                                                              
%%%%%%%%%%%%%                                                                              
%%%%%%%%%%%%                                                                               
%%%%%%%%%%%%                                         %%    %%%                             
%%%%%%%%%%%%                                        %%%    %%%                             
%%%%%%%%%%%%                                       %%%%   %%%%                             
%%%%%%%%%%%                                        %%%%  %%%%%                             
%%%%%%%%%%%                                       %%%%%  %%%%%                             
%%%%%%%%%%%                                       %%%%% %%%%%                              
%%%%%%%%%%%                                      %%%%%% %%%%%                              
%%%%%%%%%%                                       %%%%% %%%%%%                              
%%%%%%%%%%                                      %%%%%% %%%%%                               
%%%%%%%%%%                                      %%%%%% %%%%%                               
%%%%%%%%%                                       %%%%% %%%%%%                               
%%%%%%%%%                                      %%%%%% %%%%%                                
%%%%%%%%%                                      %%%%% %%%%%%                                
%%%%%%%%%                                     %%%%%% %%%%%                                 
%%%%%%%%                                      %%%%%  %%%%%                                 
%%%%%%%%                                      %%%%% %%%%%%                                 
%%%%%%%%                                      %%%%% %%%%%                                  
%%%%%%%                                      %%%%% .%%%%%                                  
%%%%%%%                                      %%%%% %%%%%%                                  
%%%%%%%                                      %%%%%.%%%%%                                   
%%%%%%                                      %%%%% .%%%%%                                   
%%%%%%                                      %%%%% .%%%%%                                   
%%%%%%                                      %%%%%.%%%%%                                    
%%%%%                                       %%%% .%%%%%                                    
%%%%%                                      %%%%%..%%%%%                                    
%%%%%                                      %%%%%..%%%%                                     
%%%%                                       %%%% .%%%%%                                     
%%%%                                       %%%%..%%%%%                                     
%%%%                                      %%%%%..%%%%                                      
%%%                                       %%%%%..%%%%                                      
%%%                                       %%%%..%%%%%                                      
%%%                                       %%%%..%%%%%                                      
%%                                       %%%%%..%%%%                                       
%%                                       %%%%%..%%%%                                       
%%                                       %%%%...%%%%                                       
%                                        %%%%..%%%%%                                       
%                                       %%%%%..%%%%                                        
%                                       %%%%%..%%%%                                        
                                        %%%%...%%%%                                        
                                        %%%%..%%%%%                                       %
                                        %%%%..%%%%%                                       %
                                       %%%%%..%%%%                                        %
                                       %%%%...%%%%                                       %%
                                       %%%%..%%%%%                                       %%
                                       %%%%..%%%%%                                       %%
                                      %%%%%..%%%%                                       %%%
                                      %%%%%..%%%%                                       %%%
                                      %%%%..%%%%%                                       %%%
                                      %%%%..%%%%%                                      %%%%
                                     %%%%%..%%%%                                       %%%%
                                     %%%%%. %%%%                                       %%%%
                                     %%%%..%%%%%                                      %%%%%
                                    %%%%%..%%%%%                                      %%%%%
                                    %%%%%. %%%%                                       %%%%%
                                    %%%%%.%%%%%                                      %%%%%%
                                   %%%%%. %%%%%                                      %%%%%%
                                   %%%%%. %%%%%                                      %%%%%%
                                   %%%%%.%%%%%                                      %%%%%%%
                                  %%%%%% %%%%%                                      %%%%%%%
                                  %%%%%. %%%%%                                      %%%%%%%
                                  %%%%% %%%%%                                      %%%%%%%%
                                 %%%%%% %%%%%                                      %%%%%%%%
                                 %%%%%  %%%%%                                      %%%%%%%%
                                 %%%%% %%%%%%                                     %%%%%%%%%
                                %%%%%% %%%%%                                      %%%%%%%%%
                                %%%%% %%%%%%                                      %%%%%%%%%
                               %%%%%% %%%%%                                       %%%%%%%%%
                               %%%%% %%%%%%                                      %%%%%%%%%%
                               %%%%% %%%%%%  P                                   %%%%%%%%%%
                              %%%%%% %%%%%                                       %%%%%%%%%%
                              %%%%% %%%%%%                                      %%%%%%%%%%%
                              %%%%% %%%%%                                       %%%%%%%%%%%
                             %%%%%  %%%%%                                       %%%%%%%%%%%
                             %%%%%  %%%%                                        %%%%%%%%%%%
                             %%%%   %%%%                                       %%%%%%%%%%%%
                             %%%    %%%                                        %%%%%%%%%%%%
                             %%%    %%                                         %%%%%%%%%%%%
                                                                               %%%%%%%%%%%%
                                                                              %%%%%%%%%%%%%
                                                                              %%%%%%%%%%%%%
                                                                              %%%%%%%%%%%%%
                                                                              %%%%%%%%%%%%%
                                                                             %%%%%%%%%%%%%%
                                                                             %%%%%%%%%%%%%%
                                                                             %%%%%%%%%%%%%%
                                                                             %%%%%%%%%%%%%%
                                                                             %%%%%%%%%%%%%%
                                                                            %%%%%%%%%%%%%%%
                                                                            %%%%%%%%%%%%%%%
                                                                            %%%%%%%%%%%%%%%
                                                                            %%%%%%%%%%%%%%%
                                                                            %%%%%%%%%%%%%%%
                                                                            %%%%%%%%%%%%%%%
                                                                            %%%%%%%%%%%%%%%
                                                                            %%%%%%%%%%%%%%%
                                                                            %%%%%%%%%%%%%%%
                                                                            %%%%%%%%%%%%%%%
                                                                            %%%%%%%%%%%%%%%
                                                                            %%%%%%%%%%%%%%%
                                                                            %%%%%%%%%%%%%%%
                                                                            %%%%%%%%%%%%%%%
                                                                            %%%%%%%%%%%%%%%
                                                                            %%%%%%%%%%%%%%%
                                                                            %%%%%%%%%%%%%%%
                                                                            %%%%%%%%%%%%%%%
                                                                            %%%%%%%%%%%%%%%
                                                                            %%%%%%%%%%%%%%%
                                                                            %%%%%%%%%%%%%%%
                                                                             %%%%%%%%%%%%%%
                                                                             %%%%%%%%%%%%%%
                                                                             %%%%%%%%%%%%%%
                                                                              %%%%%%%%%%%%%
                                                                              %%%%%%%%%%%%%
                                                                               %%%%%%%%%%%%
