%%%%%%%%                                                     
%%%%%%%%%                                                    
%%%%%%%%%                                                    
%%%%%%%%%%                                                   
%%%%%%%%%%                                                   
%%%%%%%%%%                                                   
%%%%%%%%%%                                                   
%%%%%%%%%%                                                   
%%%%%%%%%%                                                   
%%%%%%%%%%                                                   
%%%%%%%%%%                                                   
%%%%%%%%%%                                                   
%%%%%%%%%%                                                   
%%%%%%%%%%                                                   
%%%%%%%%%%                                                   
%%%%%%%%%%                                                   
%%%%%%%%%%                                                   
%%%%%%%%%%                                                   
%%%%%%%%%%                                                   
%%%%%%%%%%                                                   
%%%%%%%%%                                                    
%%%%%%%%%                                                    
%%%%%%%%%                                                    
%%%%%%%%%                                                    
%%%%%%%%                                                     
%%%%%%%%                           %%   %                    
%%%%%%%%                          %%%  %%                    
%%%%%%%%                          %%% %%%                    
%%%%%%%                          %%%% %%%                    
%%%%%%%                          %%% %%%%                    
%%%%%%%                         %%%% %%%                     
%%%%%%%                         %%%%%%%%                     
%%%%%%                          %%% %%%%                     
%%%%%%                         %%%% %%%                      
%%%%%%                         %%% %%%%                      
%%%%%                          %%% %%%                       
%%%%%                         %%%%.%%%                       
%%%%%                         %%% %%%%                       
%%%%                          %%%.%%%                        
%%%%                         %%%%.%%%                        
%%%%                         %%% .%%%                        
%%%                          %%%.%%%                         
%%%                          %%%.%%%                         
%%%                         %%%%.%%%                         
%%                          %%%..%%%                         
%%                          %%%.%%%                          
%%                          %%%.%%%                          
%                           %%..%%%                          
%                          %%%..%%%                          
%                          %%%.%%%                           
                           %%%.%%%                           
                           %%%.%%%                          %
                          %%%..%%%                          %
                          %%%..%%                           %
                          %%%.%%%                          %%
                          %%%.%%%                          %%
                         %%%..%%%                          %%
                         %%%.%%%%                         %%%
                         %%%.%%%                          %%%
                         %%%.%%%                          %%%
                        %%%. %%%                         %%%%
                        %%%.%%%%                         %%%%
                        %%%.%%%                          %%%%
                       %%%% %%%                         %%%%%
                       %%%.%%%%                         %%%%%
                       %%% %%%                          %%%%%
                      %%%% %%%                         %%%%%%
                      %%% %%%%                         %%%%%%
                     %%%% %%%                          %%%%%%
                     %%%%%%%%                         %%%%%%%
                     %%% %%%% P                       %%%%%%%
                    %%%% %%%                          %%%%%%%
                    %%% %%%%                          %%%%%%%
                    %%% %%%                          %%%%%%%%
                    %%  %%%                          %%%%%%%%
                    %   %%                           %%%%%%%%
                                                     %%%%%%%%
                                                    %%%%%%%%%
                                                    %%%%%%%%%
                                                    %%%%%%%%%
                                                    %%%%%%%%%
                                                   %%%%%%%%%%
                                                   %%%%%%%%%%
                                                   %%%%%%%%%%
                                                   %%%%%%%%%%
                                                   %%%%%%%%%%
                                                   %%%%%%%%%%
                                                   %%%%%%%%%%
                                                   %%%%%%%%%%
                                                   %%%%%%%%%%
                                                   %%%%%%%%%%
                                                   %%%%%%%%%%
                                                   %%%%%%%%%%
                                                   %%%%%%%%%%
                                                   %%%%%%%%%%
                                                   %%%%%%%%%%
                                                   %%%%%%%%%%
                                                   %%%%%%%%%%
                                                    %%%%%%%%%
                                                    %%%%%%%%%
                                                     %%%%%%%%
