%%%%%%%%%%%%%%%%%%                                           
%%%%%%%%%%%%%%%%%%                                           
%%%%%%%%%%%%%%%%%%                                           
%%%%%%%%%%%%%%%%%%                                           
%%%%%%%%%%%%%%%%%%                                           
%%%%%%%%%%%%%%%%%%                                           
%%%%%%%%%%%%%%%%%%                                           
%%%%%%%%%%%%%%%%%%                                           
%%%%%%%%%%%%%%%%%                                            
%%%%%%%%%%%%%%%%%                                            
%%%%%%%%%%%%%%%%%                                            
%%%%%%%%%%%%%%%%%                                            
%%%%%%%%%%%%%%%%                                             
%%%%%%%%%%%%%%%%                                             
%%%%%%%%%%%%%%%%                                             
%%%%%%%%%%%%%%%                                              
%%%%%%%%%%%%%%%                                              
%%%%%%%%%%%%%%%                                              
%%%%%%%%%%%%%%                            %  %               
%%%%%%%%%%%%%%                           %%%%%               
%%%%%%%%%%%%%                           %%%%%%               
%%%%%%%%%%%%%                          %%%%%%%               
%%%%%%%%%%%%%                         %%%%%%%                
%%%%%%%%%%%%                         %%%%%%%%                
%%%%%%%%%%%%                        %%%%%%%%                 
%%%%%%%%%%%                         %%%%%%%                  
%%%%%%%%%%%                        %%%%%%%                   
%%%%%%%%%%%                        %%%%%%%                   
%%%%%%%%%%%%%                     %%%%%%%                    
%%%%%%%%%%%%%%                    %%%%%%%                    
%%%%%%%%%%%%%%%                  %%%%%%%                     
%%%%%%%%%%%%%%%                  %%%%%%                      
%%%%%%%%%%%%%%%                 %%%%%%%                      
%%%%%%%%%%%%%%%%                %%%%%%%                     %
%%%%%%%%%%%%%%%%                %%%%%%                     %%
%%%%%%%%%%%%%%%%               %%%%%%%                     %%
%%%%%%%%%%%%%%%%               %%%%%%                     %%%
%%%%%%%%%%%%%%%%              %%%%%%%                    %%%%
%%%%%%%%%%%%%%%               %%%%%%%                   %%%%%
%%%%%%%%%%%%%%%              %%%%%%%                   %%%%%%
%%%%%%%%%%%%%%%              %%%%%%%                   %%%%%%
%%%%%%%%%%%%%%%              %%%%%%%                  %%%%%%%
%%%%%%%%%%%%%%%             %%%%%%%                   %%%%%%%
%%%%%%%%%%%%%%              %%%%%%%                  %%%%%%%%
%%%%%%%%%%%%%%              %%%%%%%                 %%%%%%%%%
%%%%%%%%%%%%%%             %%%%%%%%                 %%%%%%%%%
%%%%%%%%%%%%%              %%%%%%%                 %%%%%%%%%%
%%%%%%%%%%%%%              %%%%%%%                 %%%%%%%%%%
%%%%%%%%%%%%%             %%%%%%%%                %%%%%%%%%%%
%%%%%%%%%%%%              %%%%%%%%                %%%%%%%%%%%
%%%%%%%%%%%%             %%%%%%%%                %%%%%%%%%%%%
%%%%%%%%%%%              %%%%%%%%                %%%%%%%%%%%%
%%%%%%%%%%%              %%%%%%%%               %%%%%%%%%%%%%
%%%%%%%%%%              %%%%%%%%%               %%%%%%%%%%%%%
%%%%%%%%%%              %%%%%%%%%               %%%%%%%%%%%%%
%%%%%%%%%               %%%%%%%%               %%%%%%%%%%%%%%
%%%%%%%%%              %%%%%%%%%               %%%%%%%%%%%%%%
%%%%%%%%               %%%%%%%%%               %%%%%%%%%%%%%%
%%%%%%%                %% %%%%%%              %%%%%%%%%%%%%%%
%%%%%%%               %%%%%%%%%               %%%%%%%%%%%%%%%
%%%%%%                %% %%%%%%               %%%%%%%%%%%%%%%
%%%%%%               %%% %%%%%%               %%%%%%%%%%%%%%%
%%%%%                %%%%%%%%%%               %%%%%%%%%%%%%%%
%%%%                %%% %%%%%%               %%%%%%%%%%%%%%%%
%%%                 %%% %%%%%%               %%%%%%%%%%%%%%%%
%%                  %% %%%%%%%               %%%%%%%%%%%%%%%%
%%                 %%% %%%%%%                %%%%%%%%%%%%%%%%
%                 %%% %%%%%%%                %%%%%%%%%%%%%%%%
                  %%% %%%%%%%                 %%%%%%%%%%%%%%%
                 %%% .%%%%%%                  %%%%%%%%%%%%%%%
                 %%%.%%%%%%%  P               %%%%%%%%%%%%%%%
                %%%.%%%%%%%                    %%%%%%%%%%%%%%
                %%%.%%%%%%%                     %%%%%%%%%%%%%
                %% %%%%%%%                        %%%%%%%%%%%
               %% .%%%%%%%                        %%%%%%%%%%%
                  %%%%%%%                         %%%%%%%%%%%
                 %%%%%%%%                        %%%%%%%%%%%%
                %%%%%%%%                         %%%%%%%%%%%%
                %%%%%%%                         %%%%%%%%%%%%%
               %%%%%%%                          %%%%%%%%%%%%%
               %%%%%%                           %%%%%%%%%%%%%
               %%%%%                           %%%%%%%%%%%%%%
               %  %                            %%%%%%%%%%%%%%
                                              %%%%%%%%%%%%%%%
                                              %%%%%%%%%%%%%%%
                                              %%%%%%%%%%%%%%%
                                             %%%%%%%%%%%%%%%%
                                             %%%%%%%%%%%%%%%%
                                             %%%%%%%%%%%%%%%%
                                            %%%%%%%%%%%%%%%%%
                                            %%%%%%%%%%%%%%%%%
                                            %%%%%%%%%%%%%%%%%
                                            %%%%%%%%%%%%%%%%%
                                           %%%%%%%%%%%%%%%%%%
                                           %%%%%%%%%%%%%%%%%%
                                           %%%%%%%%%%%%%%%%%%
                                           %%%%%%%%%%%%%%%%%%
                                           %%%%%%%%%%%%%%%%%%
                                           %%%%%%%%%%%%%%%%%%
                                           %%%%%%%%%%%%%%%%%%
                                           %%%%%%%%%%%%%%%%%%
