%%%%%%%%                                                     
%%%%%%%%%                                                    
%%%%%%%%%%                                                   
%%%%%%%%%%%                                                  
%%%%%%%%%%%                                                  
%%%%%%%%%%%%                                                 
%%%%%%%%%%%%                                                 
%%%%%%%%%%%%                                                 
%%%%%%%%%%%%%                                                
%%%%%%%%%%%%%                                                
%%%%%%%%%%%%%                                                
%%%%%%%%%%%%%                                                
%%%%%%%%%%%%%                                                
%%%%%%%%%%%%%                                                
%%%%%%%%%%%%%                                                
%%%%%%%%%%%%                                                 
%%%%%%%%%%%%                                                 
%%%%%%%%%%%%                                                 
%%%%%%%%%%%%                                                 
%%%%%%%%%%%%                                                 
%%%%%%%%%%%%                                                 
%%%%%%%%%%%                                                  
%%%%%%%%%%%                      %%                          
%%%%%%%%%%%                     %%%                          
%%%%%%%%%%                     %%%    %%                     
%%%%%%%%%%                    %%%%    %%                     
%%%%%%%%%%                   %%%%    %%                      
%%%%%%%%%%                   %%%    %%%                      
%%%%%%%%%                   %%%%   %%%                       
%%%%%%%%%                  %%%%    %%%                       
%%%%%%%%%                  %%%    %%%  %                     
%%%%%%%%                  %%%%   %%%  %%                     
%%%%%%%%                  %%%    %%%  %%                     
%%%%%%%%                  %%%    %%  %%                      
%%%%%%%                  %%%    %%%  %%                      
%%%%%%%                  %%%    %%  %%                       
%%%%%%                   %%    %%%  %%                       
%%%%%%                  %%%    %%  %%                        
%%%%%%                  %%%    %%  %%                        
%%%%%                   %%    %%% %%                         
%%%%%                   %%    %%  %%                         
%%%%%                  %%%    %%  %%                         
%%%%                   %%%    %% %%                          
%%%%                   %%    %%  %%                          
%%%                    %%    %%  %                           
%%%                    %%    %% %%                           
%%%                    %%    %% %%                           
%%                    %%%   %%  %                            
%%                    %%    %% %%                            
%                     %%    %% %%                            
%                     %%    %% %                             
%                     %%    %%%%                             
                      %%   %% %%                             
                     %%    %% %                              
                     %%    %%%%                              
                     %%    %%%%                              
                     %%   %% %%                             %
                     %%   %%%%                              %
                    %%%   %%%%                             %%
P                   %%    %%%%                             %%
                    %%   %%%%                              %%
                    %%   %%%%                             %%%
                    %%   %%%%                             %%%
                   %%%   %%%                             %%%%
                   %%%  %%%%                             %%%%
                   %%   %%%%                             %%%%
                   %%   %%%                             %%%%%
                  %%%  %%%%                             %%%%%
                  %%%  %%%%                             %%%%%
                  %%   %%%                             %%%%%%
                 %%%  %%%%                             %%%%%%
                 %%%  %%%                             %%%%%%%
                 %%%  %%%                             %%%%%%%
                %%%  %%%                              %%%%%%%
                %%%  %%%                             %%%%%%%%
               %%%% %%%                              %%%%%%%%
               %%% %%%                               %%%%%%%%
              %%%% %%%                              %%%%%%%%%
              %%% %%%                               %%%%%%%%%
             %%%%%%%%                               %%%%%%%%%
            %%%% %%%                               %%%%%%%%%%
           %%%%  %%                                %%%%%%%%%%
           %%%  %%                                 %%%%%%%%%%
          %%%                                     %%%%%%%%%%%
          %%                                      %%%%%%%%%%%
          %                                       %%%%%%%%%%%
                                                  %%%%%%%%%%%
                                                 %%%%%%%%%%%%
                                                 %%%%%%%%%%%%
                                                 %%%%%%%%%%%%
                                                 %%%%%%%%%%%%
                                                 %%%%%%%%%%%%
                                                %%%%%%%%%%%%%
                                                %%%%%%%%%%%%%
                                                %%%%%%%%%%%%%
                                                %%%%%%%%%%%%%
                                                %%%%%%%%%%%%%
                                                %%%%%%%%%%%%%
                                                %%%%%%%%%%%%%
                                                 %%%%%%%%%%%%
                                                 %%%%%%%%%%%%
                                                 %%%%%%%%%%%%
                                                 %%%%%%%%%%%%
                                                  %%%%%%%%%%%
                                                   %%%%%%%%%%
                                                   %%%%%%%%%%
                                                    %%%%%%%%%
