%%%%%           %%         %%%%  %%%%
%%%%%%          %%         %%%%    %%
%%%%%%%         %%         %%%%      
%%%%%%%         %%         %%%%      
%%%%%%%%        %%%        %%%%      
%%%%%%%%        %%%        %%%%      
%%%%%%%%        %%%        %%%%      
%%%%%%%%        %%%%       %%%%      
%%%%%%%%        %%%%%      %%%%      
%%%%%%%%        %%%%%%%%%% %%%%      
%%%%%%%%        %%%%%%%%%  %%%%      
%%%%%%%         %%%%%%%    %%%%      
%%%%%%%         %%%%%%     %%%%      
%%%%%%%         %%%%       %%%%      
%%%%%%%         %%%        %%%%      
%%%%%%          %%         %%%%      
%%%%%%          %%         %%%%      
%%%%%%          %%         %%%%      
%%%%%    %      %%         %%%%      
%%%%%   %%      %%         %%%%      
%%%%%   %       %%         %%%%      
%%%%   %%       %%         %%%%      
%%%%   %        %%         %%%%      
%%%%  %%        %%         %%%%      
%%%   %         %%         %%%%      
%%%   %         %%         %%%%      
%%   %%         %%         %%%%      
%%  %%          %%         %%%%      
%%   %          %%         %%%%      
%  %%%          %%         %%%%      
%  %%           %%         %%%%      
  % %           %%         %%%%      
  % %           %%         %%%%      
 % %            %%         %%%%      
 % %            %%         %%%%     %
 % %            %%         %%%%     %
% %             %%         %%%%    %%
% %             %%         %%%%    %%
  %             %%         %%%%    %%
.%%             %%         %%%%   %%%
.%              %%         %%%%   %%%
 %              %%         %%%%  %%%%
%               %%         %%%%  %%%%
%               %%         %%%%  %%%%
                %%         %%%% %%%%%
                %%         %%%% %%%%%
                %%         %%%% %%%%%
                %%         %%%%%%%%%%
                %%         %%%%%%%%%%
                %%         %%%%%%%%%%
               %%%         %%%%%%%%%%
              %%%%         %%%%%%%%%%
            %%%%%%         %%%%%%%%%%
          %%%%%%%%         %%%%%%%%%%
         %%%%%%%%%         %%%%%%%%%%
        %%%%%%%%%%         %%%%%%%%%%
        %    %%%%%         %%%%%%%%%%
              %%%%         %%%%%%%%%%
              %%%%         %%%%%%%%%%
               %%%         %%%%%%%%%%
               %%%         %%%%%%%%%%
               %%%         %%%%%%%%%%
               %%%         %%%%%%%%%%
                %%   %     %%%%%%%%%%
P               %%   %%%%  %%%% %%%%%
