%%%%%%%%%%%%%%%%%%%%%%%%%%%                                                                
%%%%%%%%%%%%%%%%%%%%%%%%%%%                                                                
%%%%%%%%%%%%%%%%%%%%%%%%%%%                                                                
%%%%%%%%%%%%%%%%%%%%%%%%%%%                                                                
%%%%%%%%%%%%%%%%%%%%%%%%%%%                                                                
%%%%%%%%%%%%%%%%%%%%%%%%%%%                                                                
%%%%%%%%%%%%%%%%%%%%%%%%%%%                                                                
%%%%%%%%%%%%%%%%%%%%%%%%%%%                                                                
%%%%%%%%%%%%%%%%%%%%%%%%%%%                                                                
%%%%%%%%%%%%%%%%%%%%%%%%%%                                                                 
%%%%%%%%%%%%%%%%%%%%%%%%%%                                                                 
%%%%%%%%%%%%%%%%%%%%%%%%%%                                                                 
%%%%%%%%%%%%%%%%%%%%%%%%%%                                                                 
%%%%%%%%%%%%%%%%%%%%%%%%%%                                                                 
%%%%%%%%%%%%%%%%%%%%%%%%%                                                                  
%%%%%%%%%%%%%%%%%%%%%%%%%                                                                  
%%%%%%%%%%%%%%%%%%%%%%%%%                                                                  
%%%%%%%%%%%%%%%%%%%%%%%%                                                                   
%%%%%%%%%%%%%%%%%%%%%%%%                                                                   
%%%%%%%%%%%%%%%%%%%%%%%%                                                                   
%%%%%%%%%%%%%%%%%%%%%%%                                                                    
%%%%%%%%%%%%%%%%%%%%%%%                                                                    
%%%%%%%%%%%%%%%%%%%%%%%                                                                    
%%%%%%%%%%%%%%%%%%%%%%                                                                     
%%%%%%%%%%%%%%%%%%%%%%                                                                     
%%%%%%%%%%%%%%%%%%%%%%                                                                     
%%%%%%%%%%%%%%%%%%%%%                                                                      
%%%%%%%%%%%%%%%%%%%%%                                          %%  %%                      
%%%%%%%%%%%%%%%%%%%%%                                         %%% %%%                      
%%%%%%%%%%%%%%%%%%%%                                         %%%%%%%%                      
%%%%%%%%%%%%%%%%%%%%                                        %%%%%%%%%                      
%%%%%%%%%%%%%%%%%%%                                        %%%%%%%%%%                      
%%%%%%%%%%%%%%%%%%%                                       %%%%%%%%%%                       
%%%%%%%%%%%%%%%%%%%                                      %%%%%%%%%%%                       
%%%%%%%%%%%%%%%%%%                                      %%%%%%%%%%%                        
%%%%%%%%%%%%%%%%%%                                     %%%%%%%%%%%                         
%%%%%%%%%%%%%%%%%                                     %%%%%%%%%%%%                         
%%%%%%%%%%%%%%%%%                                     %%%%%%%%%%%                          
%%%%%%%%%%%%%%%%%                                    %%%%%%%%%%%                           
%%%%%%%%%%%%%%%%                                    %%%%%%%%%%%                            
%%%%%%%%%%%%%%%%                                    %%%%%%%%%%%                            
%%%%%%%%%%%%%%%                                    %%%%%%%%%%%                             
%%%%%%%%%%%%%%%%%%%                                %%%%%%%%%%                              
%%%%%%%%%%%%%%%%%%%%                              %%%%%%%%%%%                              
%%%%%%%%%%%%%%%%%%%%%                             %%%%%%%%%%                               
%%%%%%%%%%%%%%%%%%%%%%                           %%%%%%%%%%%                               
%%%%%%%%%%%%%%%%%%%%%%                           %%%%%%%%%%                                
%%%%%%%%%%%%%%%%%%%%%%%                          %%%%%%%%%%                                
%%%%%%%%%%%%%%%%%%%%%%%                         %%%%%%%%%%                                 
%%%%%%%%%%%%%%%%%%%%%%%                         %%%%%%%%%%                                 
%%%%%%%%%%%%%%%%%%%%%%%                        %%%%%%%%%%                                 %
%%%%%%%%%%%%%%%%%%%%%%%                        %%%%%%%%%%                                %%
%%%%%%%%%%%%%%%%%%%%%%%                        %%%%%%%%%%                               %%%
%%%%%%%%%%%%%%%%%%%%%%%                       %%%%%%%%%%                               %%%%
%%%%%%%%%%%%%%%%%%%%%%%                       %%%%%%%%%%                              %%%%%
%%%%%%%%%%%%%%%%%%%%%%%                      %%%%%%%%%%                               %%%%%
%%%%%%%%%%%%%%%%%%%%%%%                      %%%%%%%%%%                              %%%%%%
%%%%%%%%%%%%%%%%%%%%%%%                     %%%%%%%%%%%                             %%%%%%%
%%%%%%%%%%%%%%%%%%%%%%%                     %%%%%%%%%%                             %%%%%%%%
%%%%%%%%%%%%%%%%%%%%%%%                     %%%%%%%%%%                             %%%%%%%%
%%%%%%%%%%%%%%%%%%%%%%                     %%%%%%%%%%%                            %%%%%%%%%
%%%%%%%%%%%%%%%%%%%%%%                     %%%%%%%%%%                            %%%%%%%%%%
%%%%%%%%%%%%%%%%%%%%%%                     %%%%%%%%%%                            %%%%%%%%%%
%%%%%%%%%%%%%%%%%%%%%%                    %%%%%%%%%%%                           %%%%%%%%%%%
%%%%%%%%%%%%%%%%%%%%%                     %%%%%%%%%%%                          %%%%%%%%%%%%
%%%%%%%%%%%%%%%%%%%%%                    %%%%%%%%%%%                           %%%%%%%%%%%%
%%%%%%%%%%%%%%%%%%%%%                    %%%%%%%%%%%                          %%%%%%%%%%%%%
%%%%%%%%%%%%%%%%%%%%                     %%%%%%%%%%%                          %%%%%%%%%%%%%
%%%%%%%%%%%%%%%%%%%%                    %%%%%%%%%%%%                         %%%%%%%%%%%%%%
%%%%%%%%%%%%%%%%%%%%                    %%%%%%%%%%%                          %%%%%%%%%%%%%%
%%%%%%%%%%%%%%%%%%%                     %%%%%%%%%%%                         %%%%%%%%%%%%%%%
%%%%%%%%%%%%%%%%%%%                    %%%%%%%%%%%%                         %%%%%%%%%%%%%%%
%%%%%%%%%%%%%%%%%%%                    %%%%%%%%%%%%                        %%%%%%%%%%%%%%%%
%%%%%%%%%%%%%%%%%%                     %%%%%%%%%%%                         %%%%%%%%%%%%%%%%
%%%%%%%%%%%%%%%%%%                    %%%%%%%%%%%%                        %%%%%%%%%%%%%%%%%
%%%%%%%%%%%%%%%%%                     %%%%%%%%%%%%                        %%%%%%%%%%%%%%%%%
%%%%%%%%%%%%%%%%%                     %%%%%%%%%%%%                       %%%%%%%%%%%%%%%%%%
%%%%%%%%%%%%%%%%                     %%%%%%%%%%%%                        %%%%%%%%%%%%%%%%%%
%%%%%%%%%%%%%%%%                     %%%%%%%%%%%%                       %%%%%%%%%%%%%%%%%%%
%%%%%%%%%%%%%%%                      %%%%%%%%%%%%                       %%%%%%%%%%%%%%%%%%%
%%%%%%%%%%%%%%%                     %%%%%%%%%%%%%                       %%%%%%%%%%%%%%%%%%%
%%%%%%%%%%%%%%                      %%%%%%%%%%%%%                      %%%%%%%%%%%%%%%%%%%%
%%%%%%%%%%%%%%                      %%%%%%%%%%%%                       %%%%%%%%%%%%%%%%%%%%
%%%%%%%%%%%%%                      %%%%%%%%%%%%%                       %%%%%%%%%%%%%%%%%%%%
%%%%%%%%%%%%%                      %%%%%%%%%%%%%                      %%%%%%%%%%%%%%%%%%%%%
%%%%%%%%%%%%                      %%%% %%%%%%%%%                      %%%%%%%%%%%%%%%%%%%%%
%%%%%%%%%%%%                      %%%%%%%%%%%%%                       %%%%%%%%%%%%%%%%%%%%%
%%%%%%%%%%%                       %%%%%%%%%%%%%                      %%%%%%%%%%%%%%%%%%%%%%
%%%%%%%%%%                       %%%% %%%%%%%%%                      %%%%%%%%%%%%%%%%%%%%%%
%%%%%%%%%%                       %%%% %%%%%%%%%                      %%%%%%%%%%%%%%%%%%%%%%
%%%%%%%%%                       %%%% %%%%%%%%%                       %%%%%%%%%%%%%%%%%%%%%%
%%%%%%%%                        %%%% %%%%%%%%%                      %%%%%%%%%%%%%%%%%%%%%%%
%%%%%%%%                        %%%% %%%%%%%%%                      %%%%%%%%%%%%%%%%%%%%%%%
%%%%%%%                        %%%% %%%%%%%%%%                      %%%%%%%%%%%%%%%%%%%%%%%
%%%%%%                         %%%% %%%%%%%%%                       %%%%%%%%%%%%%%%%%%%%%%%
%%%%%                         %%%%  %%%%%%%%%                       %%%%%%%%%%%%%%%%%%%%%%%
%%%%%                         %%%% %%%%%%%%%%                       %%%%%%%%%%%%%%%%%%%%%%%
%%%%                         %%%%  %%%%%%%%%                        %%%%%%%%%%%%%%%%%%%%%%%
%%%                          %%%% %%%%%%%%%%                        %%%%%%%%%%%%%%%%%%%%%%%
%%                          %%%%% %%%%%%%%%%                        %%%%%%%%%%%%%%%%%%%%%%%
%                           %%%%  %%%%%%%%%%                        %%%%%%%%%%%%%%%%%%%%%%%
                           %%%%% %%%%%%%%%%                         %%%%%%%%%%%%%%%%%%%%%%%
                           %%%%  %%%%%%%%%%                         %%%%%%%%%%%%%%%%%%%%%%%
                          %%%%%.%%%%%%%%%%                          %%%%%%%%%%%%%%%%%%%%%%%
                         %%%%% .%%%%%%%%%%                           %%%%%%%%%%%%%%%%%%%%%%
                         %%%% .%%%%%%%%%%%   P                       %%%%%%%%%%%%%%%%%%%%%%
                        %%%%%..%%%%%%%%%%                             %%%%%%%%%%%%%%%%%%%%%
                        %%%% .%%%%%%%%%%%                              %%%%%%%%%%%%%%%%%%%%
                        %%%%..%%%%%%%%%%                                %%%%%%%%%%%%%%%%%%%
                       %%%% .%%%%%%%%%%%                                    %%%%%%%%%%%%%%%
                       %%% .%%%%%%%%%%%                                    %%%%%%%%%%%%%%%%
                       %%% .%%%%%%%%%%%                                    %%%%%%%%%%%%%%%%
                       %%  %%%%%%%%%%%                                    %%%%%%%%%%%%%%%%%
                          %%%%%%%%%%%                                     %%%%%%%%%%%%%%%%%
                         %%%%%%%%%%%%                                     %%%%%%%%%%%%%%%%%
                         %%%%%%%%%%%                                     %%%%%%%%%%%%%%%%%%
                        %%%%%%%%%%%                                      %%%%%%%%%%%%%%%%%%
                       %%%%%%%%%%%                                      %%%%%%%%%%%%%%%%%%%
                       %%%%%%%%%%                                       %%%%%%%%%%%%%%%%%%%
                      %%%%%%%%%%                                        %%%%%%%%%%%%%%%%%%%
                      %%%%%%%%%                                        %%%%%%%%%%%%%%%%%%%%
                      %%%%%%%%                                         %%%%%%%%%%%%%%%%%%%%
                      %%% %%%                                         %%%%%%%%%%%%%%%%%%%%%
                      %%  %%                                          %%%%%%%%%%%%%%%%%%%%%
                                                                      %%%%%%%%%%%%%%%%%%%%%
                                                                     %%%%%%%%%%%%%%%%%%%%%%
                                                                     %%%%%%%%%%%%%%%%%%%%%%
                                                                     %%%%%%%%%%%%%%%%%%%%%%
                                                                    %%%%%%%%%%%%%%%%%%%%%%%
                                                                    %%%%%%%%%%%%%%%%%%%%%%%
                                                                    %%%%%%%%%%%%%%%%%%%%%%%
                                                                   %%%%%%%%%%%%%%%%%%%%%%%%
                                                                   %%%%%%%%%%%%%%%%%%%%%%%%
                                                                   %%%%%%%%%%%%%%%%%%%%%%%%
                                                                  %%%%%%%%%%%%%%%%%%%%%%%%%
                                                                  %%%%%%%%%%%%%%%%%%%%%%%%%
                                                                  %%%%%%%%%%%%%%%%%%%%%%%%%
                                                                 %%%%%%%%%%%%%%%%%%%%%%%%%%
                                                                 %%%%%%%%%%%%%%%%%%%%%%%%%%
                                                                 %%%%%%%%%%%%%%%%%%%%%%%%%%
                                                                 %%%%%%%%%%%%%%%%%%%%%%%%%%
                                                                 %%%%%%%%%%%%%%%%%%%%%%%%%%
                                                                %%%%%%%%%%%%%%%%%%%%%%%%%%%
                                                                %%%%%%%%%%%%%%%%%%%%%%%%%%%
                                                                %%%%%%%%%%%%%%%%%%%%%%%%%%%
                                                                %%%%%%%%%%%%%%%%%%%%%%%%%%%
                                                                %%%%%%%%%%%%%%%%%%%%%%%%%%%
                                                                %%%%%%%%%%%%%%%%%%%%%%%%%%%
                                                                %%%%%%%%%%%%%%%%%%%%%%%%%%%
                                                                %%%%%%%%%%%%%%%%%%%%%%%%%%%
                                                                %%%%%%%%%%%%%%%%%%%%%%%%%%%
